Level 2
15 11
###############
#             #
############# #
#             #
# #############
#             #
############# #
#             #
#             #
######G########
###############
START 1 1
ENEMY 1 7 STRAIGHT
DOOR 13 6 BLUE
KEY 6 1 BLUE