Level 3
20 20
####################
#   #       #   # G#
#    #  # # # # # ##
#    #  # # # # #  #
#    #  # # # # #  #
#    #  # # # # #  #
#    #  # # # # #  #
#       # #   #    #
######### ##########
#                  #
######### ##########
#       # #        #
#       # #        #
#       # #        #
#       # #        #
#       # #        #
#                  #
#                  #
#                  #
####################
START 9 9
ENEMY 9 16 STRAIGHT
DOOR 17 2 BLUE
KEY 1 1 BLUE