Level 2
15 11
###############
#             #
############# #
#             #
# #############
#             #
############# #
#             #
#             #
######G########
###############
START 5 1
DOOR 13 6 BLUE
KEY 6 1 BLUE
SMART 9 3
TELEPORTER 1 1 2 7
TELEPORTER 1 7 2 1
Ben 2.2
hahaha 2.0
OnlyTwentyCharacters 2.5