Level 1
15 10
###############
#             #
######   # #  #
##       ######
#######       #
#G            #
####   ########
#             #
#             #
###############
START 6 1
TOKEN 6 2
TOKEN 7 2
TOKEN 8 2
ENEMY 5 5 STRAIGHT
DOOR 13 8 BLUE
KEY 6 3 BLUE
KEY 6 4 RED